F 255,100,,,,,0
WE ./path_to_the_west_texture 
SO ./path_to_the_south_texture

C 225,30,0

        
EA ./path_to_the_east_texture

NO ./path_to_the_north_texture 


        1111111111111111111111111
        1000000000110000000000001
        10110000011100000N0000001
        1001000000000000000000001
111111111011000001110000000000001
100000000011000001110111111111111
111111111111111111111111111111111111111111110111111111011100000010001
111101111111110111010100100011111111111111111
11 000000110101011100000010001111111111111111111
100000000000000011000000100011111111111111111111111111111111111111
10000000000000001101010010001
11000000110101011111011110N0111
11110111 1110101 101111010001
11111111 1111111 111111111111































