NO ./textures/wall_north.xpm
SO ./textures/wall_north.xpm
WE ./textures/wall_north.xpm
EA ./textures/wall_north.xpm
F 255,255,255
C 255,255,215
           11111111111 11111111111111
           1000000000110000S000000101
           1011000001100000S00000011
           1001000000000000S0000001
11111111101100000111000000000000111
10000000001100S0W1110111111111011
11110111111111011100000100011111
11110111111111011101010010011
11000000110101011100000010001
10000000000000001100010010001
10000000000000001101010010001
11000001110101011111011100101
1110111 11100110111101000111
11111111 1111111 11111111111