NO ./path_to_the_north_texture
SO ./path_to_the_south_ texture
WE ./path_to_the_west_texture
EA ./path_to_the_east_texture
F 120,100,0
C 22,122,0


           1111111111111111111111111                              1
           1000000000110000000000010                             101
           101100000110000000000001                               1
           100100000000000000000001
11111111101100000111000000000000111
100000000011000001110111111111011
11110111111W1110111000001000111
11110111111111011101010010011
11000000110101011100000010001
10000000000000001100010010001
10000000000000001101010010001
11000001110101011111011100101
1110111 1110101 011110100011
11111111 1111111 11111111111