NO ./path_to_the_north_texture
SO ./path_to_the_south_texture
WE ./path_to_the_west_texture
EA ./path_to_the_east_texture
F 220,100,0
C 225,30,0



           1111111111111111111111111                              1
           1000000000110000000000010                             11
           101100000110000000000001                               1
           100100000000000000000001
11111111101100000111000000000000111
100000000011000001110111111111011
11110111111W1110111000001000111
11110111111111011101010010011
11000000110101011100000010001
10000000000000001100010010001
10000000000000001101010010001
11000001110101011111011100111
1110111 1110101 01111010001
11111111 1111111 11111111111
