NO ./textures/wall_north.xpm
SO ./textures/wall_north.xpm
WE ./textures/wall_north.xpm
EA ./textures/wall_north.xpm

F 255,1,1
C 25,1,1

111111111111111111111111111111111111111111
100000000000000000000000000000000000000001
10000000000000000000000000000000000000001
100000000000000000000000000000000000000001
1000001111111100000000000011111110000000001
100000100000010000000000001000001000000001
100000100000010000000000001000001000000001
100000100000010000000000001000001000000001
10000011100111000000000001111111000000001
10000000000000000000000000000000000011111
10000000111000000000000000000000000000001
10000000000000000N000000000000000011111111
100000000000000011000000000000000000000001
100000000000000000000000000000000000000001
100000111111110000000000001111100000000111
10000010000010000000000001000001000000001
100000100000010000000000001000001000000001
100000100000010000000000001000001000000001
100000111001110000000000001111111000000001
100000000000000000000000000000000000000001
100000000000000000000000000000000000000001
100000000000000000000000000000000000000001
1000000000000000000000000000000000000000001
100000000000000000000000000000000000000001
1111111111111111111111111111111111111111111