NO ./textures/wall_north.xpm
SO ./textures/wall_north.xpm
WE ./textures/wall_north.xpm
EA ./textures/wall_north.xpm
F 50,50,50
C 100,150,200

111111111111111111111111111111111111111111
100000000000000000000000000000000000000001
100000000000000000000000000000000000000001
100000000000000000000000000000000000000001
100000111111110000000000001111111000000001
100000100000010000000000001000001000000001
100000100000010000000000001000001000000001
100000100000010000000000001000001000000001
100000111001110000000000001111111000000001
100000000000000000000000000000000000000001
100000000000000000000000000000000000000001
100000000000000000N000000I0000000000000001
100000000000000000000000000000000000000001
100000000000000000000000000000000000000001
10000011111111000000000000111D111000000001
100000100000010000000000001000001000000001
100000100000010000000000001000001000000001
100000100000010000000000001000001000000001
100000111001110000000000001111111000000001
100000000000000000000000000000000000000001
100000000000000000000000000000000000000001
100000000000000000000000000000000000000001
100000000000000000000000000000000000000001
100000000000000000000000000000000000000001
111111111111111111111111111111111111111111
