NO ./textures/wall_north.xpm
SO ./textures/wall_north.xpm
WE ./textures/wall_north.xpm
EA ./textures/wall_north.xpm
F 255,0,0
C 255,0,0

111111111111111111111111111111111111111111
100000000000000000000000000000000000000001
100000000000000000000000000000000000000001
100000000000000000000000000000000000000001
100000111111110000000000001111111000000001
100000100000010000000000001000001000000001
100000100000010000000000001000001000000001
100000100000010000000000001000001000000001
100000111001110000000000001111111000000001
100000000000000000000000000000000000000001
100000000000000000000000000000000000000001
100000000000000000NIIIIII0I0000000000000001
100000000000000000000000000000000000000001
100000000000000000000000000000000000000001
1000001111111100000000000011D111000000001
100000100000010000000000001000001000000001
100000100000010000000000001000001000000001
100000100000010000000000001000001000000001
100000111001110000000000001111111000000001
100000000000000000000000000000000000000001
100000000000000000000000000000000000000001
100000000000000000000000000000000000000001
100000000000000000000000000000000000000001
100000000000000000000000000000000000000001
111111111111111111111111111111111111111111
