NO ./textures/wall_north.xpm
SO ./textures/wall_north.xpm
WE ./textures/wall_north.xpm
EA ./textures/wall_north.xpm

F 255,1,1
C 25,1,1

111111111111111111111111111111111111111111
100000000000000000000000000000000000000001
100000000000000000000000000000000000000001
100000000000000000000000000000000000000001
100000111111110000000000001111111000000001
100000100000010000000000001000001000000001
100000100000010000000000001000001000000001
100000100000010000000000001000001000000001
100000111001110000000000001111111000000001
10000000000000000000000000000000000011D111
1000000011D1000000000000000000000000000001
10000000000000000N000000000000000011111111
10000000000000001D1000000000000000000000001
100000000000000000000000000000000000000001
100000111111110000000000001111100000000111
10000010000010000000000001000001000000001
100000100000010000000000001000001000000001
100000100000010000000000001000001000000001
100000111001110000000000001111111000000001
100000000000000000000000000000000000000001
100000000000000000000000000000000000000001
100000000000000000000000000000000000000001
1000000000000000000000000000000000000000001
100000000000000000000000000000000000000001
111111111111111111111111111111111111111111