NO ./textures/wall_north.xpm
SO ./textures/wall_north.xpm
WE ./textures/wall_north.xpm
EA ./textures/wall_north.xpm
F 30,30,30
C 80,120,180

1111111111111111111111
1000000000000000000001
1000000000000000000001
1001111D1111D11110001
1001000000000000010001
1001000000000000010001
100100000N0000000D0001
1001000000000000010001
1001000000000000010001
1001111D1111111110001
1000000000000000000001
1000000000000000000001
1111111111111111111111
