NO ./textures/wall_north.xpm
SO ./textures/wall_north.xpm
WE ./textures/wall_north.xpm
EA ./textures/wall_north.xpm
F 40,40,40
C 100,100,150

111111111111111111111111
100000000000000000000001
100X00000000000000X00001
100000000000000000000001
100000X000000000X0000001
100000000000000000000001
10000000000N000000000001
100000000000000000000001
100000X000000000X0000001
100000000000000000000001
100X00000000000000X00001
100000000000000000000001
111111111111111111111111
