NO ./textures/wall_north.xpm
SO ./textures/wall_north.xpm
WE ./textures/wall_north.xpm
EA ./textures/wall_north.xpm
F 20,20,25
C 70,90,130

1111111111111111111111111111
1000001000000000000000000001
1X10101011111111111111111101
1010101000000000000000000101
1010101011111111111111110101
1010101010000000000000010101
1010101010111111111110010101
10101010100000000001X0010101
1010101010111111110100010101
1010101010100000010100010101
1010101010101110010100010101
1010101010101010010100010101
10101010101010N0010100010101
1010101010101011110100010101
1010101010100000000100010101
1010101010111111110100010101
1010101010000000000100010101
101010D011111111111100010101
1010100000000000000000010101
1010111111111111111111110101
1010000000000000000000000101
1011111111111111111111111101
1000000000000000000000X00001
1111111111111111111111111111
