NO ./textures/wall_north.xpm
SO ./textures/wall_north.xpm
WE ./textures/wall_north.xpm
EA ./textures/wall_north.xpm
F 60,50,40
C 120,160,200

11111111111111111111111111111111
10000000000000000000000000000001
10000000000000000000000000000001
10011111D11111100001111D1111001
10010000000000100001000000010001
10010X000000001D0001000X000D0001
10010000000000100001000000010001
10011111D11111100001111111110001
10000000000000000000000000000001
10000000000000000000000000000001
10011111111111100001111111110001
10010000000000100001000000010001
1001000N00X000100001000X00010001
10010000000000100001000000010001
10011111D11111100001111D1111001
10000000000000000000000000000001
10000000000000000000000000000001
11111111111111111111111111111111
