NO ./textures/wall_north.xpm
SO ./textures/wall_north.xpm
WE ./textures/wall_north.xpm
EA ./textures/wall_north.xpm
F 50,50,50
C 100,150,200

111111111111111111111111111111
100000000000000000000000000001
100000000000000000000000000001
100000111D111000001111D111001
100000100000100000100000100001
100000100X00100000100X00100001
100000100000100000100000100001
100000111D11100000111111100001
100000000000000000000000000001
1000000000N0000000000X00000001
100000000000000000000000000001
100000111111100001111D1110001
100000100000100000100000100001
100000100X00100000100X00100001
100000100000100000100000100001
100000111D111000001111D111001
100000000000000000000000000001
100000000000000000000000000001
111111111111111111111111111111
